Tôi có 10 triệu thì tôi có thể mua được mẫu điện thoại nào tốt nhất?	Bên mình có các mẫu điện thoại như Iphone 11, Samsung Galaxy A54, Samsung Galaxy A53, Samsung Galaxy A34, Samsung Galaxy A14, OPPO A95,...
Samsung Galaxy Z Flip4 có giá bao nhiêu?	Hiện tại, Samsung Galaxy Z Flip4 có giá 12990000.
Điện thoại nào có camera tốt nhất hiện nay?	Điện thoại có camera tốt nhất hiện nay là Iphone 15.
Điện thoại có hỗ trợ sạc nhanh không?	Dạ có ạ.
Tôi cần tìm thông tin về kích thước màn hình của các dòng điện thoại khác nhau.	Xin quý khách hãy gọi đến tổng đài tư vấn để biết thêm chi tiết.
Tôi muốn mua một ốp lưng bảo vệ cho điện thoại Samsung Galaxy S22. Shop có thể đề xuất một số loại ốp lưng phù hợp không?	Bên mình có rất nhiều mẫu ốp lưng cho Samsung Galaxy S22, quý khách muốn chọn mẫu nào ạ.
Điện thoại nào có khả năng chống nước và chống bụi tốt? Bên mình có các sản phẩm có khả năng chống nước và chống bụi tốt như iPhone 15 Pro Max, Samsung Galaxy S23 Ultra, OPPO Find X5 Pro 5G, Google Pixel 7 Pro, Xiaomi 12S Ultra,...
Tôi muốn mua một chiếc điện thoại dùng để chơi game, bạn có thể gợi ý một số option phù hợp không?	Một số lựa chọn phù hợp shop gợi ý cho bạn như iPhone 15 Pro Max, Samsung Galaxy S23 Ultra, OPPO Find X5 Pro 5G, Google Pixel 7 Pro, Xiaomi 12S Ultra
Tôi đang gặp sự cố với điện thoại của mình, làm thế nào để khắc phục?	Cụ thể là như thế nào ạ. Nếu được, bạn có thể đem điện thoại tới shop để được hỗ trợ tốt nhất.
Điện thoại nào có chất lượng âm thanh tốt nhất cho việc nghe nhạc?	Bên mình gợi ý cho bạn các sản phẩm như iPhone 15 Pro Max, Samsung Galaxy S23 Ultra, OPPO Find X5 Pro 5G, Google Pixel 7 Pro, Xiaomi 12S Ultra. Ngoài ra, một số điện thoại tầm trung cũng có chất lượng âm thanh tốt, chẳng hạn như Samsung Galaxy A53, OPPO Reno7 Pro, Realme GT 2 Pro.
Giá của Samsung Galaxy S23 hiện tại là bao nhiêu?	Giá của điện thoại Samsung Galaxy S23 hiện tại là 18990000đ.
Giá của Samsung Galaxy S23 Plus hiện tại là bao nhiêu?	Giá của điện thoại Samsung Galaxy S23 Plus hiện tại là 21990000đ.
Giá của Samsung Galaxy S23 Ultra hiện tại là bao nhiêu?	xin lỗi quý khách, Fpt shop không có kinh doanh mặt hàng này ạ.
Giá của OPPO Find X5 Pro hiện tại là bao nhiêu?	Giá của OPPO Find X5 hiện tại là 32990000đ.
Cho tôi đặt hàng sản phẩm OPPO Find X5 Pro.	Xin lỗi quý khách, sản phẩm hiện đang hết hàng. Quý khách có thể đăng kí trước sản phẩm ạ.
Giá của Pixel 7 hiện tại là bao nhiêu?	Xin lỗi quý khách, shop hiện tại không kinh doanh sản phẩm này ạ.
Giá của Pixel 7 Pro hiện tại là bao nhiêu?	Xin lỗi quý khách, shop hiện tại không kinh doanh sản phẩm này ạ.
Giá của OPPO Reno8 hiện tại là bao nhiêu?	Giá của OPPO Reno8 hiện tại là 6990000₫ nhưng sản phẩm đang tạm hết hàng ạ.
Giá của Xiaomi 12S hiện tại là bao nhiêu?	Xin lỗi quý khách, shop hiện tại không kinh doanh sản phẩm này ạ.
Giá của Xiaomi 12S Pro hiện tại là bao nhiêu?	Xin lỗi quý khách, shop hiện tại không kinh doanh sản phẩm này ạ.
Giá của Xiaomi 12S Ultra hiện tại là bao nhiêu?	Xin lỗi quý khách, shop hiện tại không kinh doanh sản phẩm này ạ.
Giá của Vivo V25 hiện tại là bao nhiêu?	Giá của Vivo V25 hiện tại là 6990000₫
Giá của Vivo V25 Pro hiện tại là bao nhiêu?	Giá của Vivo V25 Pro hiện tại là 9990000₫.
Giá của Vivo V25e hiện tại là bao nhiêu?	Giá của Vivo V25e hiện tại là 5990000₫.
Giá của realme C51 hiện tại là bao nhiêu?	Giá của realme C51 hiện tại là 3790000₫.
Giá của realme 11 hiện tại là bao nhiêu?	Giá của realme 11 hiện tại là 6990000₫.
Giá của realme 11 Pro hiện tại là bao nhiêu?	Giá của realme 11 Pro hiện tại là 11490000₫.
Giá của realme C30s hiện tại là bao nhiêu?	Giá của realme C30s hiện tại là 2390000₫.
Giá của realme C55 hiện tại là bao nhiêu?	Giá của realme C55 hiện tại là 4390000₫.
iPhone 15 có điểm gì nổi bật?	iPhone 15 được trang bị chip A16 Bionic, chip xử lý mạnh mẽ nhất của Apple, được trang bị hệ thống camera chính 48MP, camera góc siêu rộng 12MP và camera tele 12MP, mang lại chất lượng hình ảnh và video tốt hơn, iPhone 15 có thời lượng pin dài hơn so với thế hệ trước, mang lại thời gian sử dụng lâu hơn cho người dùng.
Sự khác nhau giữa iPhone 15 và iPhone 15 Plus.	Hai phiên bản này có thiết kế và cấu hình tương tự nhau, chỉ khác nhau về kích thước màn hình. iPhone 15 có màn hình 6,1 inch, còn iPhone 15 Plus có màn hình 6,7 inch.
Sự khác nhau giữa iPhone 15 Pro và iPhone 15 Pro Max.	Hai phiên bản này có thiết kế cao cấp hơn với khung viền titan, màn hình ProMotion 120Hz và cảm biến LiDAR. iPhone 15 Pro có màn hình 6,1 inch, còn iPhone 15 Pro Max có màn hình 6,7 inch.
Samsung Galaxy S23 có gì nổi bật?	Galaxy S23 được trang bị màn hình Dynamic AMOLED 2X với độ phân giải Full HD+ hoặc QHD+, tần số quét 120Hz. Được trang bị hệ thống camera sau với camera chính 50MP, camera góc siêu rộng 12MP và camera tele 10MP. Galaxy S23 được trang bị chip Snapdragon 8 Gen 2, RAM 8GB hoặc 12GB, bộ nhớ trong 128GB, 256GB, 512GB hoặc 1TB. Galaxy S23 có dung lượng pin 4.000mAh, hỗ trợ sạc nhanh 25W.Galaxy S23 được trang bị bút S Pen, hỗ trợ 5G, chống nước IP68.
Có ốp cho điện thoại Samsung Galaxy Z Flip4 không ?	Bên mình có ốp lưng dành cho Samsung Galaxy Z Flip4 với nhiều mẫu khác nhau.
Samsung Galaxy Z Fold5 có giá bao nhiêu?	Samsung Galaxy Z Fold5 hiện tại có giá là 31990000₫
Có ốp cho điện thoại Samsung Galaxy Z Fold5 không?	Bên mình có ốp lưng dành cho Samsung Galaxy Z Fold5 với nhiều mẫu khác nhau.
Shop mình có bán Samsung Galaxy Tab S9 không?	Dạ có ạ, Shop mình có bán Samsung Galaxy Tab S9 với mức giá 20390000₫.
Điện thoại iPhone 15 có hỗ trợ nhiều sim không?	Có, iPhone 15 hỗ trợ nhiều sim. Cụ thể, tất cả các phiên bản iPhone 15 đều hỗ trợ 2 SIM (1 SIM vật lý và 1 eSIM).
Galaxy tab s9 và s9 plus có gì khác biệt?	Galaxy Tab S9 có kích thước màn hình 11 inch, trong khi Galaxy Tab S9 Plus có kích thước màn hình 12,4 inch. Galaxy Tab S9 Plus có dung lượng pin 10.090mAh, trong khi Galaxy Tab S9 có dung lượng pin 8.000mAh. Galaxy Tab S9 Plus có RAM 12GB, trong khi Galaxy Tab S9 có RAM 8GB. Cả hai chiếc máy đều có hệ thống camera sau 108MP, 12MP, 10MP. Tuy nhiên, Galaxy Tab S9 Plus có camera trước 12MP, trong khi Galaxy Tab S9 có camera trước 8MP.
Điện thoại Samsung có hỗ trợ sạc không dây không? Có, điện thoại Samsung hỗ trợ sạc không dây. Hầu hết các điện thoại Samsung cao cấp đều hỗ trợ sạc không dây Qi, bao gồm các dòng Galaxy S, Galaxy Note, Galaxy Z và Galaxy A.
Tôi muốn mua sạc không dây cho Samsung.	Shop mình có nhiều loại sạc không dây khác nhau, quý khách muốn mua loại nào ạ.
Bên mình có máy cũ iPhone 14 pro max 512gb màu tím cũ giá bao nhiêu ạ?	Dạ hiện bên shop chỉ còn iPhone 14 Pro Max 512GB cũ màu tím với giá ưu đãi 30035280đ.
Cho em hỏi iPhone 11 pro max cũ 256gb khoảng bao nhiêu ạ?	Dạ sản phẩm này bên Shop hiện tại không kinh doanh ạ. Mình vui lòng tham khảo các sản phẩm khác tương tự nhé. Để được hỗ trợ chi tiết về sản phẩm quý khách liên hệ tổng đài miễn phí 18006601 hoặc để lại SĐT bên mình liên hệ tư vấn nhanh nhất ạ.
Mình muốn mua iPad Pro 12.9 2022 M2 cũ.	Dạ shop mình có bán iPad Pro 12.9 2022 M2 cũ giá dao động từ 23 triệu đồng đến 35 triệu đồng.
Màn hình phụ Samsung Galaxy Z Flip5 có thể làm được gì?	Với màn hình lớn nâng cấp lên tới 3.4 inch, Samsung Galaxy Z Flip5 có không gian thao tác thoải mái hơn. Đồng thời, bạn cũng sẽ tùy thích tùy chỉnh nhiều chế độ widget tiện lợi (có hơn 12 widget); xem thông báo, tin nhắn, cuộc gọi trực quan; soạn thảo văn bản; sử dụng nhiều ứng dụng hơn (Google Maps, Youtube, Spotify,...); xem ảnh chụp trước rõ ràng, cá nhân hóa với nhiều hình nền tùy chỉnh,...
Thiết kế Samsung Galaxy Z Flip5 có gì cải tiến?	Thiết kế Samsung Galaxy Z Flip5 có rất nhiều điểm cải tiến sáng giá, có thể kể dến như màn hình ngoài lớn đến 3.4 inch (bản cũ chỉ 1.9 inch), bản lề mới không khoản hở khi gập lại, nếp gấp giảm 40$ so với tiền nhiệm, tổng thể mỏng gọn hơn,... giúp người dùng tận hưởng chiếc smartphone gập mới, nhỏ gọn, vùa vặn, hiện đại và tiện lợi hơn bap giờ.
Hiệu năng Samsung Galaxy Z Flip5 như thế nào?	Hiệu năng Samsung Galaxy Z Flip5 mạnh mẽ với con chip đầu bảng Snapdragon 8 Gen 2 for Galaxy. Con chip này sản xuất trên tiến trình mới 4nm, với nhãn Cortex-A715 xung nhịp đến 3.36GHz, cho hiệu năng CPU tăng đến 17%, đảm bảo xử lí mượt mọi tác vụ, ngay cả các tựa game mobile nặng hiện nay.
iPhone 15 Pro Max được làm từ chất liệu gì?	iPhone 15 Pro Max có phần khung kết hợp từ nhôm và titan; mặt trước Ceramic Shield; mặt sau bằng kính nhám.
Điện thoại nào khỏe nhất hiện nay?	Điện thoại khỏe nhất hiện nay là Asus ROG Phone 6. Chiếc điện thoại này được trang bị chip xử lý Snapdragon 8+ Gen 1, RAM 18GB và bộ nhớ trong 1TB. Ngoài ra, Asus ROG Phone 6 còn được trang bị màn hình AMOLED 6,78 inch, tần số quét 165Hz và hệ thống tản nhiệt tiên tiến. Điều này giúp Asus ROG Phone 6 có thể chơi game trong thời gian dài mà không bị quá nhiệt.
iPhone 15 Pro Max có mấy màu?	iPhone 15 Pro Max hiện có 4 màu, bao gồm Titan Đen, Titan Trắng, Titan Xanh, Titan Tự Nhiên.
iPhone 15 Pro Max rẻ nhất ở đâu?	Hiện tại, iPhone 15 Pro Max đang có mặt trên các cửa hàng ở toàn quốc với mức giá ngang nhau. Nếu quý khách có nhu cầu mua, xin hãy đến của hàng gần nhất hoặc đặt hàng online.





