Mức giá tầm trung cho một bộ máy tính gaming là bao nhiêu?	Mức giá tầm trung cho một bộ máy tính gaming hiện nay dao động từ 15 triệu đến 30 triệu đồng. Với mức giá này, bạn có thể sở hữu một bộ máy tính có thể chơi được hầu hết các tựa game hiện nay ở cài đặt đồ họa trung bình đến cao.
Bạn có thể gợi ý cho tôi một số dòng laptop gaming phổ biến tầm khoảng 15 đến 30 triệu?	Bên mình có các dòng laptop như Acer Nitro 5, Dell G15, MSI GF63 Thin 11UD, HP Victus 15, Lenovo Legion 5. Để được hỗ trợ chi tiết về sản phẩm, bạn vui lòng liên hệ tổng đài miễn phí 18006601 hoặc để lại SĐT bên mình liên hệ tư vấn nhanh nhất ạ.
Máy tính gaming nên có bao nhiêu RAM để đáp ứng nhu cầu chơi game hiện nay?	Với 16GB RAM, bạn có thể chơi hầu hết các tựa game hiện nay ở cài đặt đồ họa trung bình đến cao. Nếu bạn muốn chơi game ở cài đặt đồ họa cao nhất, bạn nên nâng cấp lên 32GB RAM.
Tôi muốn build một bộ pc có thể chơi được game AAA với giá cả hợp lý.	Đây là một cấu hình PC chơi game AAA giá rẻ mà bạn có thể tham khảo: CPU: Intel Core i5-12400F, Mainboard: MSI B660M-A Pro, RAM: 16GB DDR4-3200, VGA: NVIDIA GeForce RTX 3060, SSD: 500GB M.2 NVMe, HDD: 1TB SATA 3, PSU: Corsair CX550M, Case: Cooler Master MasterBox TD500 Mesh ATX. Tổng chi phí cho cấu hình này sẽ khoảng 35 triệu đồng.
Latop Lenovo Legion 5 pro có giá bao nhiêu?	Hiện tại, latop Lenovo Legion 5 pro có giá là 33990000₫
Core Intel và ryzen có gì khác nhau?	Core Intel có hiệu năng đơn luồng tốt để chơi game, chỉnh sửa video hoặc thực hiện các tác vụ chuyên nghiệp khác. Core Ryzen có giá thành rẻ, tiêu thụ điện năng thấp và số lượng lõi và luồng nhiều.
laptop gaming tốt nhất hiện nay là gì?	Laptop gaming tốt nhất hiện nay là Asus ROG Zephyrus G15. Chiếc laptop này được trang bị chip xử lý Intel Core i9-12900H, card đồ họa NVIDIA GeForce RTX 3080 Ti, RAM 32GB DDR5 và SSD 1TB PCIe 4.0. Với cấu hình này, Asus ROG Zephyrus G15 có thể chơi được các game AAA ở mức đồ họa cao nhất với tốc độ khung hình ổn định.
Giá của laptop Asus ROG Zephyrus G15?	Xin lỗi quý khách, hiện tại shop mình không kinh doanh sản phẩm này ạ.
Tôi muốn mua một chiếc laptop gaming dòng ROG hãng Asus.	Hiện tại bên shop mình có những sản phẩm như laptop Asus Gaming ROG Strix G513RW-HQ152W, laptop Asus Gaming ROG Strix G533ZS-LN036W, laptop Asus Gaming ROG Strix G614JU-N3777W, laptop Asus Gaming ROG Zephyrus GU603VU-N3898W, laptop Asus Gaming ROG Strix G614JI-N4084W. Để được hỗ trợ chi tiết, bạn hãy để lại SĐT hoặc liên hệ tổng đài miễn phí 1800 6601, bên mình sẽ tư vấn và hỗ trợ bạn nhanh nhất bạn nhé.
Giá của những chiếc laptop nay như thế nào?	Hiện tại, giá của những chiếc laptop này dao động trong khoảng từ 35000000₫ dến 55000000₫ ạ.
Tôi muốn mua 1 thanh RAM 8gb DDR5 cho laptop của mình.	Hiện tại, bên shop mình có RAM Laptop Kingston 8GB - DDR5 - 4800MHz với mức giá 1090000₫.
Mình muốn mua một con laptop có màn hình cảm ứng, shop có bán không?	Dạ có ạ, bên mình có bán laptop có màn hình cảm ứng, quý khách muón mua mâu nào ạ?	
Tôi muốn mua một cái laptop dành cho trẻ em.	Dạ, shop hiện đang có sản phẩm laptop Masstel E140 với mức giá 3990000₫.
làm sao chiếc laptop này có thể bảo vệ con tôi trước những thông tin đoc hại?	Trên Masstel E140, nhà sản xuất đã trang bị một ứng dụng đặc biệt là SafeZone – có thể giúp bảo vệ con trẻ 24/7 khi tiếp cận môi trường internet phức tạp và hỗn loạn hiện nay. Theo đó, SafeZone không chỉ lọc bỏ những kết quả tìm kiếm có nội dung không phù hợp mà còn tiến hành ngăn chặn khi bé truy cập vào các trang web có nội dung lừa đảo, cờ bạc hoặc thiếu lành mạnh. Ứng dụng SafeZone trên Masstel E140 cũng hỗ trợ kèm cả chức năng khóa và mở máy từ xa. Nhờ vậy, phụ huynh sẽ được cấp quyền quản lý laptop mọi thời gian cực kỳ hiệu quả.
Ứng dụng SafeZone có kiểm soát được việc vào mạng xã hội của trẻ?	Ứng dụng có chức năng hiển thị lượt truy cập, ngay cả khi trẻ xóa lịch sử duyệt web, phụ huynh vẫn có thể nắm rõ những thông tin này dể đưa ra những can thiệp phù hợp.
Thời lượng pin của laptop Masstel E140?	Viên pin chất lượng cao ghi nhận thời gian hoạt động dài lâu trong từ 5 đến 7 tiếng đồng hồ. Nhờ vậy, laptop có thể phuc vụ tốt cho một buổi học, không lo bé bị gián đoạn buổi học do máy sập nguồn.
Mình mua thanh ram này về rồi đem ra cửa hàng hỗ trợ lắp ram giúp mình được ko ạ?	Dạ, vì bên mình chưa có dịch vụ nâng cấp máy tại Shop. Nên trường hợp mua máy này bên mình sẽ gửi máy về hãng để nâng cấp giúp bạn, và chi phí cụ thể phía hãng sẽ thông tin đến bạn ạ.
Mình mua máy bên fpt giờ mình gửi máy nâng ram thì có bị mất bảo hành ko ạ?	Trường hợp còn bảo hành, bạn nên gửi qua trung tâm bảo hành để được nâng cấp và giữ bảo hành bạn nhé. 
Lúc trước mình có mua con asus TUF F15 2022 mua của fpt bây giờ mình muốn vệ sinh máy với nâng thêm 1 thanh ram 8gb ddr5 thì giá khoảng bao nhiêu ạ?	Dạ bạn vui lòng mang sản phẩm qua Shop bên mình sẽ hỗ trợ gửi về trung tâm bảo hành để sản phẩm được vệ sinh và nâng cấp thêm ram 8GB DDR5 ạ. Để được hỗ trợ chi tiết, bạn hãy để lại SĐT hoặc liên hệ tổng đài miễn phí 1800 6601, bên mình sẽ tư vấn và hỗ trợ bạn nhanh nhất bạn nhé.
Mình có mua ở fpt laptop Lenovo Ideapad Gaming 3 R7 6800H 8gb Ram. Giờ mình muốn gửi qua hãng fpt để nâng cấp thêm ram thì phải đợi bao lâu vậy ạ?	Dạ trường hợp shop gửi máy về trung tâm bảo hành thì thời gian dự kiến khoảng 15 ngày ạ, nếu xong sớm thì sẽ gửi máy về sớm bạn nhé.
VGA mới nhất hiện tại.	VGA mới nhất hiện tại là Nvidi GeForce RTX 4090, AMD Radeon RX 7900 XTX.
Giá tiền của Nvidia GeForce RTX 4090 là bao nhiêu?	Tại Việt Nam, giá bán của Nvidia GeForce RTX 4090 dao động từ 50 triệu đồng đến 60 triệu đồng.
Shop có bán lẻ Nvidia GeForce RTX 4090 không?	Xin lỗi quý khách, shop hiện tại không kinh doanh sản phẩm này.
Tôi muốn mua màn hình để làm đồ họa.	Bên mình có rất nhiều màn hình từ 2k đến 5k rất thích hợp để làm đồ họa. Để được hỗ trợ chi tiết, bạn hãy để lại SĐT hoặc liên hệ tổng đài miễn phí 1800 6601, bên mình sẽ tư vấn và hỗ trợ bạn nhanh nhất bạn nhé.
Máy cũ có trả góp không ạ.	Dạ máy cũ có hỗ trợ mua trả góp ạ. Để được hỗ trợ chi tiết về sản phẩm, bạn vui lòng liên hệ tổng đài miễn phí 18006601 hoặc để lại SĐT bên mình liên hệ tư vấn nhanh nhất ạ.
Bên shop có đề xuất laptop gaming nào không?	hiện tại bên shop mình đang có rất nhiều mặt hàng laptop gaming với nhiều mức giá khác nhau, Để được hỗ trợ chi tiết về sản phẩm quý khách  liên hệ tổng đài miễn phí 18006601 hoặc để lại SĐT bên mình liên hệ tư vấn nhanh nhất ạ.


